00 00 00 00 00 00 00 00
00 00 00 00 00 00 00 00
00 00 00 00 00 00 00 00
00 00 00 00 00 00 00 00
00 00 00 00 00 00 00 00
00 00 00 00 00 00 00 00
00 00 00 00 00 00 00 00
1d 20 40 00 00 00 00 00
20 00 00 00 00 00 00 00
cd 20 40 00 00 00 00 00
66 21 40 00 00 00 00 00
44 21 40 00 00 00 00 00
85 21 40 00 00 00 00 00
f1 1f 40 00 00 00 00 00
3f 20 40 00 00 00 00 00
f1 1f 40 00 00 00 00 00
32 1f 40 00 00 00 00 00
31 35 31 66 30 34 39 63
00
